rows=16
columns=16
tile_size=16
mode=0
this is a text message
%
"                "
"                "
"                "
"                "
"           t    "
"                "
"      ggg       "
"      gpggggggg>"
"      ggg       "
"                "
"                "
"                "
"                "
"                "
"                "
"                "
