rows=16
columns=16
tile_size=16
mode=0
press x to go to the next text
:)
%
"                "
"   r            "
"        f       "
"        t   l   "
"        g       "
"        g       "
"        g       "
"pgggggggggggggg>"
"                "
"                "
"                "
"     l          "
"      l         "
" r              "
"               r"
"                "
