rows=16
columns=16
tile_size=16
mode=1
%
"     W ^ W    L "
"     W   W      "
"     W   W      "
"     W   W      "
"     W   W      "
"     W   W      "
"     W   W      "
"     W   W      "
"     W   W      "
"     W   W      "
"     W   W      "
"     W   W      "
"     W   W      "
"     W   W      "
"     W   W      "
"     W p W      "
