columns=32
rows=32
tile_size=8
"                                "
"                          g     " 
"                                "
"            g                   "
"                 R              "
"                                "
"                                "
"p       t                       "
"        t                       "
"        t             g         "
"        t                       "
"        t                       "
"        t                       "
"   R    t                       "
"        t         g             "
"        t                f      "
"        t                       "
"        t                       "
"        t                       "
"    g   t                       "
"        t        g              "
"        t                       "
"        t             g         "
"        t                       "
"        t   wwwwwwwwwwwwwwwwwwww"
"        t                       "
"        t                       "
"        ttttttttttttttttttttttt>"
"                g               "
"    g                      g    "
"                      T         "
"                 R              "
text_size=3
you are not ready
for what is ahead;
give up before you
get more hurt;
you cannot win;
