columns=16
rows=16
tile_size=8
girl_show=0
"           g    "
"     R          "
"       f        "
"       T     g  "
"  g             "
"                "
"                "
"ptttttttttttttt>"
"                "
"   R       g    "
"                "
"  g             "
"        g   R   "
"                "
"                "
"                "
text_size=1
a beautiful flower;
