columns=16
rows=16
tile_size=8
"                "
"                "
"                "
"     f      T   "
"                "
"                "
"      ttt       "
"      tpttttttt>"
"      ttt       "
"                "
"                "
"          g     "
"                "
"                "
"                "
"                "
text_size=1
hello;
