columns=16
rows=16
tile_size=8
"                "
"                "
"                "
"            T   "
"                "
"                "
"      ttt       "
"      tpttttttt>"
"      ttt       "
"                "
"                "
"                "
"                "
"                "
"                "
"                "
